----c---oooo0---
-#-#o#o#o#o#o#o#
-o------o-------
-#-#-#-#e#-#-#-#
eo----o-o----ooo
-#-#-#-#-#-#-#-#
-o--o-o--oo-oooc
c#-#-#-#-#-#-#-#
o-o-oo-o-oo-oo--
-#-#-#-#-#-#-#-#
-------oo---o-oo
