--------oooo---c
-#-#o#o#o#o#o#o#
eo------o-e-----
-#-#-#-#-#-#-#-#
-o----oooo--oooo
-#-#-#-#-#-#-#-#
-oc-o-o--oo-oooo
c#-#-#-#-#-#-#-#
o---oo-o-oo-oo--
-#-#-#-#-#-#-#-#
-------oo---o-oo
