--------oooo---c
c#-#o#o#o#o#o#o#
-oe-----o-------
-#-#-#-#-#-#-#-#
-o----o-o---oooo
-#-#-#-#-#-#-#-#
-o--o-o--eo-oooe
-#-#-#-#-#-#-#-#
o-c-oo-o-oo-oo-c
-#e#-#-#-#-#-#-#
-------oo---o-oo
