--------ooeo---c
-#-#o#o#o#o#o#o#
-o------o-------
-#-#-#-#-#-#-#-#
-o----o-e---oooo
c#-#-#-#-#-#-#-#
-o--o-o--oo-oooo
-#-#-#-#-#-#-#-#
o-o-oo-c-oo-oo-c
-#-#-#-#-#-#-#-#
e------oo---o-oe
